NO ./xpms/texture_no.xpm
SO ./xpms/texture_MISSING.xpm
WE ./xpms/texture_we.xpm
EA ./xpms/texture_ea.xpm
F 25,8,23
C 0, 0, 0

1111111
1000001
100N001
1000001
1111111