NO textures/north.xpm
SO textures/south.xpm
WE textures/west.xpm
EA textures/east.xpm

F 58,42,31
C 0, 0, 0
        1111111111111111111111111
        100000000001D000000000001
        1011000000010100000000001
        1001000000000000000000001
111111111011000001110000000000001
100000000011000001110111111111111
111101111111110111000000100D1
11110111111111011101010010001
11D00000110101011100000010001
10000000000000001100000010001
10000000000000001101010010001
11000001110101011111011110N0111
11110111 1110101 111111010001
11111111 1111111 111111111111
