NO textures/north.xpm
SO textures/south.xpm
WE textures/west.xpm
EA textures/east.xpm

F 46, 45, 45
C 0,14,89

111111111111111111111
101000001000000000001
101010101011111111111
100010100010000010001
111110101111101011101
100000101000101000001
100000000000000000001
101111101011101111111
101000001010100000101
101001111010111110101 
101010001010100010101
101110101010101010101
100000101010001010001
111111101011111011101
100000101000100000001
101110101110101110101
101000100000100011101
100001111111111010101
100011100000000000001
111111111011101111101
1N0000000000000001111
111111111111111111111
