NO textures/north.xpm
SO textures/south.xpm
WE textures/west.xpm
EA textures/east.xpm

F 46, 45, 45
C 0, 0, 0

   11111
 110001
10S011
10001
11111
