NO textures/north.xpm
SO textures/south.xpm
WE textures/west.xpm
EA textures/east.xpm

F 20, 20, 20
C 200,200,200

   11111
 110001
10S011
10001
11111
