NO textures/north.xpm
SO textures/south.xpm

WE textures/west.xpm
EA textures/east.xpm

F 46, 45, 45
C 0,14,89

11111
10001
10S01
10001
11111