F 20,20,20
NO textures/north.xpm
SO textures/south.xpm
WE textures/west.xpm
EA textures/east.xpm
C 0, 0, 0

11111
10001
10S01
10001
11111