NO textures/north.xpm
SO ./textures/south.xpm
WE textures/west.xpm
EA ./textures/east.xpm

F 46, 45, 45
C 0,14,89

111111111111111
     1W00111111
111110100011111
111100000001111
111000000000111
11000010000001
100001111100001
110000111000011
111000010000111
111100000001111
111110000011111
111111000111111
111111111111111
