NO textures/north.xpm
SO ./textures/south.xpm
WE textures/west.xpm
EA ./textures/east.xpm

F 46, 45, 45
C 0,14,89

 1111111111111
100000000000W01
100000000000001
100000000000001
100000000000001
100000000000001
100000000000001
100000000000001
11111111111111
