NO textures/north.xpm
SO ./textures/south.xpm
WE textures/west.xpm
EA ./textures/east.xpm

F 58,42,31
C 29,21,16

 1111111111111
100000000000W01
100000000000001
100000000000001
100000000000001
100000000000001
100000000000001
100000000000001
11111111111111
