NO textures/north.xpm
SO textures/south.xpm
WE textures/west.xpm
EA textures/east.xpm

F 46, 45, 45
C 0,14,89

111111111111111111111
1W0000000000000000001
111111111111111111111
