NO textures/north.xpm
SO textures/south.xpm
WE textures/west.xpm
EA textures/east.xpm

F 46, 45, 45
C 0, 0, 0

11111111111111111111111
10000A000000S0000000001
 1000000000000000000001
  1000000000000000A001
   10000000A000000001
    1000000000000001
     10000000000001
      10000A000001
       1000000001
        10000001
         100001
          1001
           11
