NO textures/north.xpm
SO ./textures/south.xpm
WE textures/west.xpm
EA ./textures/east.xpm

F 46, 45, 45
C 0,14,89

                       11111111111111111                    
                       10000000000000001                    
     11111111111111111110000000000000001                    
     10000000000000000010000000000001111                    
     10000000000000000010000000000001                       
     10000000000000000000000000000001                       
     100000000000000000100000000000011111                   
     100000000000000000100000000000000001                   
     100000111111111111100000000000000001                   
     1000001           11111110000000000111111111           
     1000001                 10000000000000000001           
     1000001                 10000000000100000001           
     1000001                 10000000000111111111           
     1000001                 100000000001                   
     1000001           111111100001111111                   
     1110111           100000000001                         
       101             100000000001                         
       101             100000000001                         
       101             100000000001           111111111111  
       101             111111000001           100000000001  
       101                  1000001           100000000001  
       101                  1000001           100000000001  
       101           1111111111011111111      100000000001  
       101           1000000000000000001111111111100000001  
       101           1000000000000000001000000000100000001  
       101           1000000000000000000000000000000000001  
       101           1111111000000010001000000000100000001  
       101           1000001000000010001111100111100000001  
       101           1000000000000010001   100100100000001  
       101           1000001000000010001   100100111011111  
  1111110111111      1111111000000010001   100100000001     
  1000000000001      1000000000000010001   100100000001     
  1000000000001      1111111111011111111   100100000001     
  1000000000001              10001         100000000001     
  1000000000001              10001         100100000001     
  1000000000001              10001         111111111111     
  1000000000001              10001                          
  1000000000001              10001                          
  1000000000001              10001                          
  10000000000011111111       10001                          
  10000000000000000001       10001                          
  10000000000011111001       10001                          
  1111111011111   1001       10001                          
       100001     1001       10001                          
       100001     1001   1111110111111                      
       100001     1001   1000000000001                      
       100001     1001   1000000000001                      
       111111     1001   1000000000001                      
                  1001   1000000000001                      
                  1111   1000000000001                      
                         1000000000001                      
                         1000000000001                      
                         1000000000001                      
                         1000000000001                      
                         1000000000001                      
                         100000N000001                      
                         1000000000001                      
                         1111111111111                      