NO textures/north.xpm
SO textures/south.xpm
WE textures/west.xpm
EA textures/east.xpm
F 220,100,rtb
C 10,10,10
111111111
1N0000001
100010001
100000001
111111111
