NO textures/north.xpm
SO textur/south.xpm
WE textures/west.xpm
EA textures/east.xpm
F 220,100,0
C 10,10,10
111111
100011
1N0011
100011
11111
