NO textures/north.xpm
SO textures/south.xpm
WE textures/west.xpm
EA textures/east.xpm
F 220,100,0
C 10,10,10
1111111111
1000000001
1000110001
100000N001
1000000001
111111110
