NO textures/north.xpm
SO textures/south.xpm
WE textures/west.xpm
EA textures/east.xpm

F 58,	42,    31
C 29,21,16

111111111111111111111
1                   1
1         D         1
1                   1
1                   1
1                   1
1                   1
1                   1
1                   1
1                   1
1                   1
1                   1
1                   1
1                   1
1                   1
1                   1
1                   1
1                   1
1         D         1
1                   1
1N                  1
111111111111111111111
