NO textures/north.xpm
SO textures/south.xpm
WE textures/west.xpm
EA textures/east.xpm

F 46, 45, 45
C 0, 0, 0

111111111111111111111111
1D000000000S0000000000D1
 10000A0000000000000001
  100000000000000A0001
   100000000000000001
    1000000000000001
     1000000D000001
      100000000001
       1000000001
        10000001
         100001
          1001
           11
