NO textures/north.xpm
SO ./textures/south.xpm
WE textures/west.xpm
EA ./textures/east.xpm

F 46, 45, 45
C 0, 0, 0

                       11111111111111111                    
                       10000000000000001                    
     11111111111111111110000000A00000001                    
     10000000000000000010000000000001111                    
     10000000000000000010000000000001                       
     1000000A0000000000D0000000000001                       
     100000000000000000100000000000011111                   
     100000000000000000100000000000000001                   
     100000111111111111100000000000000001                   
     1000001           11111110000000000111111111           
     1000001                 10000000000D00000001           
     1000001                 10000A00000100000001           
     1000001                 10000000000111111111           
     1000001                 100000000001                   
     1000001           1111111DDDD1111111                   
     111D111           100000000001                         
       101             100000000001                         
       101             100000000D01                         
       101             100000000001           111111111111  
       101             111111000001           10A000000001  
       101                  1000001           100000000001  
       101                  1000001           1000000A0001  
       101           1111111111D11111111      100000000001  
       101           1000000000000000001111111111100000001  
       101           100000A0000A0000001000000000100000001  
       101           100000000000000A00D000000000D00000001  
       101           1111111000000010001000000000100000001  
       101           10000010000000100011111001111000A0001  
       101           100000D000000010001   100100100000001  
       101           1000001000000010001   100100111D11111  
  111111D111111      1111111000000010001   100100000001     
  1000000000001      10000000A0000010001   1001000A0001     
  1000000000001      1111111111D11111111   100100000001     
  10000A0000001              10001         100000000001     
  1000000000001              10001         10010000A001     
  1000000000001              10A01         111111111111     
  1000000000001              10001                          
  1000000000001              10001                          
  100000000A001              1A001                          
  10000000000011111111       10001                          
  10000A000000D000D001       10001                          
  10000000000011111001       10001                          
  1111111D11111   1001       10001                          
       100001     1001       10001                          
       100001     1001   111111D111111                      
       100001     1001   1000000000001                      
       100001     1001   1000000000A01                      
       111111     1001   1000000000001                      
                  1001   1000000000001                      
                  1111   1000000000001                      
                         1000000000001                      
                         1000000000001                      
                         10000A0000001                      
                         1000000000001                      
                         1000000000001                      
                         100000N000001                      
                         1000000000001                      
                         1111111111111                      