NO textures/north.xpm
SO textures/south.xpm
WE textures/west.xpm
EA textures/east.xpm

F 204,	0,    200
C 0, 0, 0

111111111111111111111
1010000010000D0000001
101010101011101110001
10001010D01000D010001
11111010111D101011101
10D000101000101000001
1D00000D00000D0000001
101111101011101111111
10100000101010D000101
101011111010111110101
1D101000101010001D101
1D11101D1010101010101
10000010101000101D001
111111101011111011101
10000010100010001D001
10111010111010111D111
10100010D000100011101
101011111111111010101
100010D00D000D001D001
101010111011111111101
1N10000010000D0000D01
111111111111111111111
